#####################
#...................#
#...................#
#.#################.#
#...................#
#...................#
#####################

#####################
#...................#
#.#...#...#...#...#.#
#.#################.#
#.#...#...#...#...#.#
#...................#
#####################

#####################
#.....##.....##.....#
#.....##.....##.....#
#..#......#......#..#
#.....##.....##.....#
#.....##.....##.....#
#####################

#####################
#...................#
#..#......#......#..#
#.####..#####..####.#
#..#......#......#..#
#...................#
#####################

#####################
#.........#.........#
#.........#.........#
#...................#
#.........#.........#
#.........#.........#
#####################

#####################
#..#..#..#.#..#..#..#
#...................#
#...................#
#...................#
#..#..#..#.#..#..#..#
#####################

#####################
#....###.....###....#
#...................#
#...................#
#...................#
#....###.....###....#
#####################

#####################
#...................#
#.########.########.#
#.#...............#.#
#.########.########.#
#...................#
#####################

#####################
#...................#
#.###.###...###.###.#
#.###.###...###.###.#
#.###.###...###.###.#
#...................#
#####################

#####################
#...................#
#..#.#.#.#.#.#.#.#..#
#.#.#.#.#.#.#.#.#.#.#
#..#.#.#.#.#.#.#.#..#
#...................#
#####################

#####################
#...................#
#.#.#.#.#.#.#.#.#.#.#
#.#################.#
#.#.#.#.#.#.#.#.#.#.#
#...................#
#####################