#######
#.....#
#..#..#
#.###.#
#..#..#
#.....#
#######

#######
###.###
##...##
#.....#
##...##
###.###
#######

#######
#.....#
#.###.#
#.###.#
#.###.#
#.....#
#######

#/#/#/#
/...../
#.....#
/...../
#.....#
/...../
#/#/#/#

#######
##...##
#.....#
#.....#
#.....#
##...##
#######

#######
#..#..#
#.....#
##...##
#.....#
#..#..#
#######