#######
#.....#
#..#..#
#.###.#
#..#..#
#.....#
#######

#######
#..#..#
#..#..#
#######
#..#..#
#..#..#
#######

#######
###.###
##...##
#.....#
##...##
###.###
#######

#######
#.....#
#.###.#
#.###.#
#.###.#
#.....#
#######

#######
#..####
#.....#
#.....#
#.....#
####..#
#######

#######
##....#
##....#
##...##
#....##
#....##
#######