#/#/#/#
/...../
#.....#
/...../
#.....#
/...../
#.....#
/...../
#.....#
/...../
#.....#
/...../
#.....#
/...../
#.....#
/...../
#.....#
/...../
#.....#
/...../
#/#/#/#

#######
#.....#
#..#..#
#.....#
#..#..#
#.....#
#..#..#
#.....#
#..#..#
#.....#
#..#..#
#.....#
#..#..#
#.....#
#..#..#
#.....#
#..#..#
#.....#
#..#..#
#.....#
#######

#######
/...../
#..#..#
/...../
#..#..#
/...../
#..#..#
/...../
#..#..#
/...../
#..#..#
/...../
#..#..#
/...../
#..#..#
/...../
#..#..#
/...../
#..#..#
/...../
#######

#######
#.....#
##...##
#.....#
##...##
#.....#
##...##
#.....#
##...##
#.....#
##...##
#.....#
##...##
#.....#
##...##
#.....#
##...##
#.....#
##...##
#.....#
#######

#######
#.....#
#.....#
#.....#
#.....#
#.....#
#.....#
#..#..#
#..#..#
#..#..#
#.###.#
#..#..#
#..#..#
#..#..#
#.....#
#.....#
#.....#
#.....#
#.....#
#.....#
#######

#######
#.....#
#.....#
#.....#
###.###
#.....#
#.....#
#.....#
#.....#
#.....#
##...##
#.....#
#.....#
#.....#
#.....#
#.....#
###.###
#.....#
#.....#
#.....#
#######

#######
#.....#
#.....#
#..#..#
#.#.#.#
#..#..#
#..#..#
#..#..#
#..#..#
#..#..#
#.#.#.#
#..#..#
#..#..#
#..#..#
#..#..#
#..#..#
#.#.#.#
#..#..#
#.....#
#.....#
#######

#######
#.....#
#.....#
#.###.#
#..#..#
#..#..#
#.###.#
#.....#
#.....#
#..#..#
#.###.#
#..#..#
#.....#
#.....#
#.###.#
#..#..#
#..#..#
#.###.#
#.....#
#.....#
#######