#######
#.....#
#.....#
#.....#
#.....#
#.###.#
#..#..#
#..#..#
#.###.#
#.....#
#.....#
#.....#
#.....#
#######

#######
#.....#
#.#.#.#
#.#.#.#
#.#.#.#
#.#.#.#
#.#.#.#
#.#.#.#
#.#.#.#
#.#.#.#
#.#.#.#
#.#.#.#
#.....#
#######

#######
#.....#
#.###.#
#..#..#
#.###.#
#.....#
#.....#
#.....#
#.....#
#.###.#
#..#..#
#.###.#
#.....#
#######

#######
#.....#
#.###.#
#.#.#.#
#.#.#.#
#.#.#.#
#.#.#.#
#.#.#.#
#.#.#.#
#.#.#.#
#.#.#.#
#.###.#
#.....#
#######

#######
#.....#
##...##
#.....#
##...##
#.....#
##...##
##...##
#.....#
##...##
#.....#
##...##
#.....#
#######

#######
#.....#
#..#..#
#..#..#
#..#..#
#..#..#
#..#..#
#..#..#
#..#..#
#..#..#
#..#..#
#..#..#
#.....#
#######

#######
#.....#
#..#..#
#.....#
#..#..#
#.....#
#.....#
#.....#
#.....#
#..#..#
#.....#
#..#..#
#.....#
#######

#######
#.....#
#..#..#
#..#..#
#..#..#
#..#..#
#.###.#
#.###.#
#..#..#
#..#..#
#..#..#
#..#..#
#.....#
#######