##############
#............#
#............#
#..###..###..#
#..#......#..#
#..#......#..#
#............#
#..#......#..#
#..#......#..#
#..###..###..#
#............#
#..###..###..#
#..#......#..#
#..#......#..#
#............#
#..#......#..#
#..#......#..#
#..###..###..#
#............#
#............#
##############

##############
#............#
#............#
#..##....##..#
#..##....##..#
#............#
#............#
#..##....##..#
#..##....##..#
#............#
#............#
#............#
#..##....##..#
#..##....##..#
#............#
#............#
#..##....##..#
#..##....##..#
#............#
#............#
##############

##############
##..........##
#............#
#............#
#............#
#............#
##..........##
######..######
#............#
#............#
#............#
#............#
#............#
######..######
##..........##
#............#
#............#
#............#
#............#
##..........##
##############

##############
#............#
#............#
#...###...#..#
#.........#..#
#.........#..#
#.........#..#
#...#........#
#...#........#
#...#........#
#...#........#
#...#..###...#
#............#
#............#
#............#
#.#####...#..#
#.........#..#
#.........#..#
#.........#..#
#............#
##############

##############
#............#
#..###..###..#
#....####....#
#....####....#
#.....##.....#
#.....##.....#
#....####....#
#....####....#
#..###..###..#
#............#
#..###..###..#
#....####....#
#....####....#
#.....##.....#
#.....##.....#
#....####....#
#....####....#
#..###..###..#
#............#
##############

##############
#............#
#.....##.....#
#....####....#
#...######...#
#....####....#
#.....##.....#
#............#
#.....##.....#
#....####....#
#...######...#
#....####....#
#.....##.....#
#............#
#.....##.....#
#....####....#
#...######...#
#....####....#
#.....##.....#
#............#
##############

##############
#............#
#............#
#...#....#...#
#..###..###..#
#...#....#...#
#............#
#.....##.....#
#....####....#
#.....##.....#
#............#
#.....##.....#
#....####....#
#.....##.....#
#............#
#...#....#...#
#..###..###..#
#...#....#...#
#............#
#............#
##############

##############
#....#..#....#
#............#
#............#
#....#..#....#
######..######
#....#..#....#
#............#
#............#
#....#..#....#
######..######
#....#..#....#
#............#
#............#
#....#..#....#
######..######
#....#..#....#
#............#
#............#
#....#..#....#
##############