##############
####......####
##..........##
##..........##
#............#
#............#
#............#
#............#
#............#
#............#
##..........##
##..........##
####......####
##############

##############
#............#
#.#..........#
#.#...##.....#
#.##########.#
#.....##...#.#
#..........#.#
#.#..........#
#.#...##.....#
#.##########.#
#.....##...#.#
#..........#.#
#............#
##############

##############
#............#
#..#......#..#
#.###....###.#
#..#......#..#
#............#
#............#
#............#
#............#
#..#......#..#
#.###....###.#
#..#......#..#
#............#
##############

##############
#............#
#............#
#.##########.#
#.#..#..#..#.#
#.#..#..#..#.#
#............#
#............#
#.#..#..#..#.#
#.#..#..#..#.#
#.##########.#
#............#
#............#
##############

##############
#............#
#.#..........#
#.#####......#
#.....#......#
#............#
#............#
#............#
#............#
#......#.....#
#......#####.#
#..........#.#
#............#
##############

##############
#............#
#............#
#..###..###..#
#..#......#..#
#..#......#..#
#............#
#............#
#..#......#..#
#..#......#..#
#..###..###..#
#............#
#............#
##############

##############
#............#
#.###....###.#
#.#........#.#
#.#.##..##.#.#
#...#....#...#
#............#
#............#
#...#....#...#
#.#.##..##.#.#
#.#........#.#
#.###....###.#
#............#
##############

##############
#............#
#...#....#...#
#...#....#...#
#...#....#...#
#.####..####.#
#...#....#...#
#...#....#...#
#.####..####.#
#...#....#...#
#...#....#...#
#...#....#...#
#............#
##############

##############
#............#
#.#.##..##.#.#
#............#
#.#.##..##.#.#
#.#.#....#.#.#
#............#
#............#
#.#.#....#.#.#
#.#.##..##.#.#
#............#
#.#.##..##.#.#
#............#
##############

##############
#............#
#.....##.....#
#.....##.....#
#.....##.....#
#....####....#
#.##########.#
#.##########.#
#....####....#
#.....##.....#
#.....##.....#
#.....##.....#
#............#
##############

##############
#............#
#.##########.#
#.#........#.#
#.#.######.#.#
#.#.#....#.#.#
#.#.#.##.#.#.#
#.#.####.#.#.#
#.#......#.#.#
#.########.#.#
#..........#.#
#.##########.#
#............#
##############

##############
#...#....#...#
#............#
#...#....#...#
##.###..###.##
#...#....#...#
#............#
#............#
#...#....#...#
##.###..###.##
#...#....#...#
#............#
#...#....#...#
##############

##############
#............#
#....#..#....#
#....#..#....#
#.##########.#
#....#..#....#
#............#
#............#
#....#..#....#
#.##########.#
#....#..#....#
#....#..#....#
#............#
##############

##############
#............#
#....#..#....#
#....#..#....#
#....#..#....#
#.####..####.#
#............#
#............#
#.####..####.#
#....#..#....#
#....#..#....#
#....#..#....#
#............#
##############