#####################
#######.......#######
#####...........#####
####.............####
######.........######
##..#.#.......#.#..##
##..#..##...##..#..##
#....#...#.#...#....#
#....#....#....#....#
#....#..##.##..#....#
#.....##.....##.....#
#....##.......##....#
#...#..#.....#..#...#
#.##...#.....#...##.#
########.###.########
##......#...#......##
###.....#...#.....###
####.....#.#.....####
#####....#.#....#####
#######...#...#######
#####################

#####################
########.....########
########.....########
########.....########
########.....########
########.....########
########.....########
########.....########
#...................#
#...................#
#...................#
#...................#
#...................#
########.....########
########.....########
########.....########
########.....########
########.....########
########.....########
########.....########
#####################

#####################
#...................#
#...................#
#...................#
########.....########
#...................#
#...................#
#...................#
########.....########
#...................#
#...................#
#...................#
########.....########
#...................#
#...................#
#...................#
########.....########
#...................#
#...................#
#...................#
#####################

#####################
#......#.....#......#
#......#.....#......#
#..##...........##..#
#..##...........##..#
#......#.....#......#
#......#.....#......#
###..####...####..###
#......#.....#......#
#...................#
#.........#.........#
#...................#
#......#.....#......#
###..####...####..###
#......#.....#......#
#......#.....#......#
#..##...........##..#
#..##...........##..#
#......#.....#......#
#......#.....#......#
#####################

#####################
#...................#
#...................#
#...................#
#...######.######...#
#...#......#....#...#
#...#...........#...#
#...#...........#...#
#...#......#....#...#
#...#......##..##...#
#...................#
#...##..##......#...#
#...#....#......#...#
#...#...........#...#
#...#...........#...#
#...#....#......#...#
#...######.######...#
#...................#
#...................#
#...................#
#####################

#####################
#...................#
#...................#
#....##.......##....#
#....##.......##....#
#..######.#.######..#
#..######...######..#
#....##.......##....#
#....##.##.##.##....#
#.......#...#.......#
#....#.........#....#
#.......#...#.......#
#....##.##.##.##....#
#....##.......##....#
#..######...######..#
#..######.#.######..#
#....##.......##....#
#....##.......##....#
#...................#
#...................#
#####################

#####################
#...................#
#...................#
#...#...........#...#
#..###.........###..#
#...#...........#...#
#...................#
#........###........#
#.......#####.......#
#......#######......#
#......#######......#
#......#######......#
#.......#####.......#
#........###........#
#...................#
#...#...........#...#
#..###.........###..#
#...#...........#...#
#...................#
#...................#
#####################

#####################
#......#.....#......#
#......#.....#......#
#......#.....#......#
#......#.....#......#
#......#.....#......#
#......#.....#......#
###..#####.#####..###
#...................#
#...................#
#...................#
#...................#
#...................#
###..#####.#####..###
#......#.....#......#
#......#.....#......#
#......#.....#......#
#......#.....#......#
#......#.....#......#
#......#.....#......#
#####################

#####################
#...................#
#...................#
#...................#
#.......#####.......#
#........###........#
#........###........#
#........###........#
#...#....###....#...#
#...#############...#
#...#############...#
#...#############...#
#...#....###....#...#
#........###........#
#........###........#
#........###........#
#.......#####.......#
#...................#
#...................#
#...................#
#####################

#####################
#...#...#...#...#...#
#...................#
#...#...#...#...#...#
##.###.###.###.###.##
#...#...#...#...#...#
#...................#
#...#...#...#...#...#
##.###.###.###.###.##
#...#...#...#...#...#
#...................#
#...#...#...#...#...#
##.###.###.###.###.##
#...#...#...#...#...#
#...................#
#...#...#...#...#...#
##.###.###.###.###.##
#...#...#...#...#...#
#...................#
#...#...#...#...#...#
#####################