#####################
#...#...#...#...#...#
#...#...#...#...#...#
#...#...#...#...#...#
##.###.###.###.###.##
#...#...#...#...#...#
#...................#
#...................#
#...#...#...#...#...#
##.###.###.###.###.##
#...#...#...#...#...#
#...#...#...#...#...#
#...#...#...#...#...#
#####################

#####################
#...................#
#.##.##.......##.##.#
#.#...#.......#...#.#
#.....####.####.....#
#.#...#.......#...#.#
#.#...#.......#...#.#
#.#...#.......#...#.#
#.#...#.......#...#.#
#.....####.####.....#
#.#...#.......#...#.#
#.##.##.......##.##.#
#...................#
#####################

#####################
#...................#
#...................#
#........#.#........#
#.......##.##.......#
#......##...##......#
###.####.....##.....#
#.....##.....####.###
#......##...##......#
#.......##.##.......#
#........#.#........#
#...................#
#...................#
#####################

#####################
#...................#
#...#...........#...#
#..###.........###..#
#.###.....#.....###.#
#..#.....###.....#..#
#.......#####.......#
#.......#####.......#
#..#.....###.....#..#
#.###.....#.....###.#
#..###.........###..#
#...#...........#...#
#...................#
#####################

#####################
#.....#....#...#....#
#..............#....#
#.....#....#...#....#
#.....##.###...#....#
#.....#...###.####.##
#.....#...#.....#...#
###.###.............#
#.....#...#.....#...#
#.....#...##.#####.##
#.........#...#.....#
#.....#.............#
#.....#...#...#.....#
#####################

#####################
###..#..#...#..#..###
###..#..#...#..#..###
#...................#
#...................#
#...................#
#...................#
#...................#
#...................#
#...................#
#...................#
###..#..#...#..#..###
###..#..#...#..#..###
#####################

#####################
#......###..........#
#......###......#...#
#...#...#...#..####.#
#..##......###..###.#
#..####...###...##..#
#...###...###.......#
#...#.....##........#
#..........#....##..#
#......#.......###..#
##.#..###......#.##.#
####....#...#.......#
####.......###......#
#####################

#####################
#....#....#....#....#
#....#....#....#....#
#....#....#....#....#
#....#....#....#....#
##..###..###..###..##
#...................#
#...................#
##..###..###..###..##
#....#....#....#....#
#....#....#....#....#
#....#....#....#....#
#....#....#....#....#
#####################

#####################
#...................#
#...................#
#..#.#...#.#...#.#..#
#..###...###...###..#
#..#.#...#.#...#.#..#
#...................#
#...................#
#.....#.#...#.#.....#
#.....###...###.....#
#.....#.#...#.#.....#
#...................#
#...................#
#####################

#####################
#...................#
#...................#
#....##.......##....#
#....##.......##....#
#..######.....##....#
#..######.....##....#
#....##.....######..#
#....##.....######..#
#....##.......##....#
#....##.......##....#
#...................#
#...................#
#####################

#####################
#...................#
#.....##............#
#.....##............#
#..########..##..#..#
#..#......#......#..#
#..#......#......#..#
#..#......#......#..#
#..#......#......#..#
#..#..##..########..#
#............##.....#
#............##.....#
#...................#
#####################

#####################
#...................#
#......#######......#
#.........#.........#
#......#.###.#......#
#......#.###.#......#
#......#######......#
#......#######......#
#.......#.#.#.......#
#...................#
#.......#.#.#.......#
#.......#####.......#
#...................#
#####################