##############
#............#
#.##########.#
#............#
#.##########.#
#............#
##############

##############
#............#
#............#
#.##########.#
#............#
#............#
##############

##############
#............#
#.....##.....#
#.##########.#
#.....##.....#
#............#
##############

##############
#............#
#............#
#.#.#....#.#.#
#............#
#............#
##############

##############
#.#.#.##.#.#.#
#............#
#............#
#............#
#.#.#.##.#.#.#
##############

##############
#............#
#.#.#....#.#.#
#.###....###.#
#.#.#....#.#.#
#............#
##############

##############
#............#
#....#..#....#
#....####....#
#....#..#....#
#............#
##############

##############
#............#
#.#.#....#.#.#
#............#
#.#.#....#.#.#
#............#
##############

##############
###........###
#............#
#............#
#............#
###........###
##############

##############
#..###..###..#
#............#
##..........##
#............#
#..###..###..#
##############

##############
#............#
#.#.#.#.#.#..#
#..#.#.#.#.#.#
#.#.#.#.#.#..#
#............#
##############